###################################
#                                 #
#     #     #                     #
#                       #         #
#      @                 #        #
#               #         #       #
#               #          #      #
#                           #     #
#                                 #
#####              ###########    #
###                               #
#####                             #
#                                 #
#                                 #
#          #               ##     #
#                           #     #
#                                 #
#                                 #
#             #######             #
#                                 #
#                                 #
#                                 #
#       ###############           #
# #################               #
###################################